Literární teorie


téma - o èem ta kniha je
motiv - proè nìco postavy udìlaly, vìc, událost, emoce
èasoprostor - co to asi bude, hmmmmmmmmmmmmmmmmmmm xd
kompozice - seøazení dìjù - chronologická
			  - paralelní = více postav vypráví více pøíbìhù
		          - retrospektivní = konec na zaèátku, vyprávìní, jak se to stalo
			  - rámcová = prostì pøátelé si vypráví pøíbìhy (dekameron)


Lit. formy - drama = prostì scénáø lol
	   - próza = neveršovaný
	   - poesie = básnièky


Lit. druhy - epika = focus na pøíbìh
	   - lyrika = feels (hodnì)
	   - drama = prostì text k divadlu

Lit. žánry - nekoneèno (drama - tragédie, komedie | epika - scifi, román, novela,... | lyrika - balada, báseò,...)

vypravìè (Ich forma - personální vyp., Er forma - vševìdoucí vyp., neosobní) / lyrický subjekt 


Postavy - hlavní
	- vedlejší
	- kladní
	- záporní


vyprávìcí zpùsoby ( pouze próza ) - pøímá øeè -> úvozovky
				  - nevlastní pøímá øeè ->  
				  - nepøímá øeè -> øekl, že ...
				  - polopøímá øeè -> 3.os. 

typy promluv ( dramata ) - dialog
			 - monolog

veršová výstavba - poèet slabik
		 - verše
		 - sloky
		 - rýmy
		 - rýmové schéma -> AA BB - sdružený
				 -> AB BA - obkroèný
				 -> AB AB - støídavý
				 -> AB CB (random písmenka) - pøerývaný
				 -> AB CD AB CD - postupný
				 -> AA AA - tirádový


prostøedky - spisovná / nespisovná
		      knižní / náøeèí
		      hovorová / argot
		      neutrální / vulgarismy
        				/ slang
        				/ interdialekty
        				/ obecná èeština	
        				/ profesní mluva
        				/ sociolekt
        				/ etnolekt
				

Archaismy - staré a nepoužívají se 

Historismy - už jich není potøeba

neologismus - nové slova

poetismy - pro básnické retardy

termíny - prostì odobrná výrazy LULW

publicismy - výrazy pro novináøe 
	


		Tropy a figury - básnické prostøedky

tropy - vytvoøení básnického obrazu - prostì metafory LULW - ze vnìjška

	   netonimie - na základì vnitøní souvislo - hlava státu

       hyperbola - pøehánìní
    
       pøirovnání - chytrý jako sova 
       
       metonopie - pøenesení významu na základu vnitøní souvislosti(snìdl celý talíø)
       
       metofora - pøenesení významu na základì vnìjší podobnosti (zub pily)
    
       synekdocha - èást za celek, nebo naopak (nepøišla ani noha) (Ostrava vyhrála v Praze)
       
       alegorie - prostì naznaèení, pomocí nìèeho jiného  (skrytý význam)
       
       inverze - prostì zpøeházená slova
       
       personifikace - zosobòování
       
       dysfemismus - mrtvý = chcípnul
       
       symbol - nìco pro znázornìní nìèeho
       
       eufemismus - mrtvý = odešel
       
       oxymorón - spojení navzájem vyluèujících významù (hlasité ticho)



 figury - nemá znázornit žádný obraz
       
       elipsa - prostì osekaná vìta, která dává smysl
       
       øeènická otázka - neodpovídat
       
       anafora - po sobì jdoucí verše zaèínají stejným slovem
       
       epifora - to samé jako anafora, ale je to na konci LULW
       
       apostrofa - oslovení nìèeho abstraktního
        
       epizeuxis - opakování jednoho slova ve verši 
       
       aliterace - opakování hlásky na nebo skupin hlásek na zaèátku slov veršù
       
       gradace - stupòování